NO ../textures/stone_wall.ppm
SO ../textures/stone_wall1.ppm
WE ../textures/stone_wall2.ppm
EA ../textures/stone_wall.ppm


F 220,100,0
C 225,30,0

11111111
10000001
11000011
10000011
10100N01
10000001
10110001
11111111
